11111
1P111
10111
1CE11
11111
11111